aaaaaaaaaaaaa
a211111112aaa
a100a0a00100a
a100axa001a1a
a100aaa001a0a
a1000a0001a0a
a1a00000a1a1a
a1000p000100a
a211111112aaa
aaaaaaaaaaaaa